"filename", "language", "JSON", "Rust", "Markdown", "TOML", "comment", "blank", "total"
"c:\Users\licht\OneDrive\Dokumentumok\rust_learning\rust_learning\dbms\Cargo.lock", "TOML", 0, 0, 0, 46, 2, 7, 55
"c:\Users\licht\OneDrive\Dokumentumok\rust_learning\rust_learning\dbms\Cargo.toml", "TOML", 0, 0, 0, 6, 1, 3, 10
"c:\Users\licht\OneDrive\Dokumentumok\rust_learning\rust_learning\dbms\query_lang_compiler_notes.md", "Markdown", 0, 0, 350, 0, 0, 24, 374
"c:\Users\licht\OneDrive\Dokumentumok\rust_learning\rust_learning\dbms\readme.md", "Markdown", 0, 0, 8, 0, 0, 6, 14
"c:\Users\licht\OneDrive\Dokumentumok\rust_learning\rust_learning\dbms\src\lib.rs", "Rust", 0, 4, 0, 0, 0, 1, 5
"c:\Users\licht\OneDrive\Dokumentumok\rust_learning\rust_learning\dbms\src\main.rs", "Rust", 0, 20, 0, 0, 1, 10, 31
"c:\Users\licht\OneDrive\Dokumentumok\rust_learning\rust_learning\dbms\src\query_parser.rs", "Rust", 0, 23, 0, 0, 0, 5, 28
"c:\Users\licht\OneDrive\Dokumentumok\rust_learning\rust_learning\dbms\src\query_parser\boolean_expression.rs", "Rust", 0, 96, 0, 0, 0, 22, 118
"c:\Users\licht\OneDrive\Dokumentumok\rust_learning\rust_learning\dbms\src\query_parser\calculated_value.rs", "Rust", 0, 145, 0, 0, 0, 41, 186
"c:\Users\licht\OneDrive\Dokumentumok\rust_learning\rust_learning\dbms\src\query_parser\compared_value.rs", "Rust", 0, 92, 0, 0, 0, 28, 120
"c:\Users\licht\OneDrive\Dokumentumok\rust_learning\rust_learning\dbms\src\query_parser\constant_calculated_value.rs", "Rust", 0, 130, 0, 0, 0, 33, 163
"c:\Users\licht\OneDrive\Dokumentumok\rust_learning\rust_learning\dbms\src\query_parser\insert_statement.rs", "Rust", 0, 67, 0, 0, 0, 24, 91
"c:\Users\licht\OneDrive\Dokumentumok\rust_learning\rust_learning\dbms\src\query_parser\select_statement.rs", "Rust", 0, 107, 0, 0, 0, 21, 128
"c:\Users\licht\OneDrive\Dokumentumok\rust_learning\rust_learning\dbms\src\query_parser\token_supplier.rs", "Rust", 0, 44, 0, 0, 0, 9, 53
"c:\Users\licht\OneDrive\Dokumentumok\rust_learning\rust_learning\dbms\src\query_tokenizer.rs", "Rust", 0, 367, 0, 0, 1, 19, 387
"c:\Users\licht\OneDrive\Dokumentumok\rust_learning\rust_learning\dbms\src\rel_alg_ast.rs", "Rust", 0, 74, 0, 0, 0, 7, 81
"c:\Users\licht\OneDrive\Dokumentumok\rust_learning\rust_learning\dbms\src\schema.rs", "Rust", 0, 7, 0, 0, 0, 3, 10
"c:\Users\licht\OneDrive\Dokumentumok\rust_learning\rust_learning\dbms\src\tokenizer.rs", "Rust", 0, 70, 0, 0, 2, 18, 90
"c:\Users\licht\OneDrive\Dokumentumok\rust_learning\rust_learning\dbms\target\.rustc_info.json", "JSON", 1, 0, 0, 0, 0, 0, 1
"c:\Users\licht\OneDrive\Dokumentumok\rust_learning\rust_learning\dbms\target\debug\.fingerprint\aho-corasick-5fbed4569f7322b1\lib-aho_corasick.json", "JSON", 1, 0, 0, 0, 0, 0, 1
"c:\Users\licht\OneDrive\Dokumentumok\rust_learning\rust_learning\dbms\target\debug\.fingerprint\aho-corasick-ac296d7c4a3012f9\lib-aho_corasick.json", "JSON", 1, 0, 0, 0, 0, 0, 1
"c:\Users\licht\OneDrive\Dokumentumok\rust_learning\rust_learning\dbms\target\debug\.fingerprint\dbms-0d8ec299979095e8\test-bin-dbms.json", "JSON", 1, 0, 0, 0, 0, 0, 1
"c:\Users\licht\OneDrive\Dokumentumok\rust_learning\rust_learning\dbms\target\debug\.fingerprint\dbms-0f7f84e9404454e8\lib-dbms.json", "JSON", 1, 0, 0, 0, 0, 0, 1
"c:\Users\licht\OneDrive\Dokumentumok\rust_learning\rust_learning\dbms\target\debug\.fingerprint\dbms-1ee994bf34f81aec\lib-dbms.json", "JSON", 1, 0, 0, 0, 0, 0, 1
"c:\Users\licht\OneDrive\Dokumentumok\rust_learning\rust_learning\dbms\target\debug\.fingerprint\dbms-43efff3c94ba70d0\lib-dbms.json", "JSON", 1, 0, 0, 0, 0, 0, 1
"c:\Users\licht\OneDrive\Dokumentumok\rust_learning\rust_learning\dbms\target\debug\.fingerprint\dbms-4f89a6c1466db84b\bin-dbms.json", "JSON", 1, 0, 0, 0, 0, 0, 1
"c:\Users\licht\OneDrive\Dokumentumok\rust_learning\rust_learning\dbms\target\debug\.fingerprint\dbms-84ebdc93f809a03a\test-bin-dbms.json", "JSON", 1, 0, 0, 0, 0, 0, 1
"c:\Users\licht\OneDrive\Dokumentumok\rust_learning\rust_learning\dbms\target\debug\.fingerprint\dbms-86fb62bb0019fd58\test-lib-dbms.json", "JSON", 1, 0, 0, 0, 0, 0, 1
"c:\Users\licht\OneDrive\Dokumentumok\rust_learning\rust_learning\dbms\target\debug\.fingerprint\dbms-8d04f1a7b564e634\bin-dbms.json", "JSON", 1, 0, 0, 0, 0, 0, 1
"c:\Users\licht\OneDrive\Dokumentumok\rust_learning\rust_learning\dbms\target\debug\.fingerprint\dbms-9e47b7611965c24a\test-bin-dbms.json", "JSON", 1, 0, 0, 0, 0, 0, 1
"c:\Users\licht\OneDrive\Dokumentumok\rust_learning\rust_learning\dbms\target\debug\.fingerprint\dbms-a8de09c7b4e6171b\test-bin-dbms.json", "JSON", 1, 0, 0, 0, 0, 0, 1
"c:\Users\licht\OneDrive\Dokumentumok\rust_learning\rust_learning\dbms\target\debug\.fingerprint\dbms-b13023237217514d\test-lib-dbms.json", "JSON", 1, 0, 0, 0, 0, 0, 1
"c:\Users\licht\OneDrive\Dokumentumok\rust_learning\rust_learning\dbms\target\debug\.fingerprint\dbms-c5347ff741cbeb43\bin-dbms.json", "JSON", 1, 0, 0, 0, 0, 0, 1
"c:\Users\licht\OneDrive\Dokumentumok\rust_learning\rust_learning\dbms\target\debug\.fingerprint\dbms-c908797cd095be4f\test-lib-dbms.json", "JSON", 1, 0, 0, 0, 0, 0, 1
"c:\Users\licht\OneDrive\Dokumentumok\rust_learning\rust_learning\dbms\target\debug\.fingerprint\dbms-d7e5d1156438ee54\lib-dbms.json", "JSON", 1, 0, 0, 0, 0, 0, 1
"c:\Users\licht\OneDrive\Dokumentumok\rust_learning\rust_learning\dbms\target\debug\.fingerprint\dbms-edc2f3c23440eaf8\test-lib-dbms.json", "JSON", 1, 0, 0, 0, 0, 0, 1
"c:\Users\licht\OneDrive\Dokumentumok\rust_learning\rust_learning\dbms\target\debug\.fingerprint\memchr-c2c471bfe782be8b\lib-memchr.json", "JSON", 1, 0, 0, 0, 0, 0, 1
"c:\Users\licht\OneDrive\Dokumentumok\rust_learning\rust_learning\dbms\target\debug\.fingerprint\memchr-f7617b312c3c8ac4\lib-memchr.json", "JSON", 1, 0, 0, 0, 0, 0, 1
"c:\Users\licht\OneDrive\Dokumentumok\rust_learning\rust_learning\dbms\target\debug\.fingerprint\regex-03c263a527171006\lib-regex.json", "JSON", 1, 0, 0, 0, 0, 0, 1
"c:\Users\licht\OneDrive\Dokumentumok\rust_learning\rust_learning\dbms\target\debug\.fingerprint\regex-718fa749abadfbef\lib-regex.json", "JSON", 1, 0, 0, 0, 0, 0, 1
"c:\Users\licht\OneDrive\Dokumentumok\rust_learning\rust_learning\dbms\target\debug\.fingerprint\regex-automata-17774fcfba4551ce\lib-regex-automata.json", "JSON", 1, 0, 0, 0, 0, 0, 1
"c:\Users\licht\OneDrive\Dokumentumok\rust_learning\rust_learning\dbms\target\debug\.fingerprint\regex-automata-a1e448695604ad49\lib-regex-automata.json", "JSON", 1, 0, 0, 0, 0, 0, 1
"c:\Users\licht\OneDrive\Dokumentumok\rust_learning\rust_learning\dbms\target\debug\.fingerprint\regex-syntax-0c1524f5a3a71929\lib-regex-syntax.json", "JSON", 1, 0, 0, 0, 0, 0, 1
"c:\Users\licht\OneDrive\Dokumentumok\rust_learning\rust_learning\dbms\target\debug\.fingerprint\regex-syntax-f5baa12cf1cc0597\lib-regex-syntax.json", "JSON", 1, 0, 0, 0, 0, 0, 1
"Total", "-", 26, 1246, 358, 52, 7, 281, 1970